#,Name,Type1,Type2,Total,HP,Bs.Atk,Bs.Def,Sp.Atk,Sp.Def,Speed,Generation,Legendary,Primal,Mega,Attack,Defense,Attack_level,Defense_level,Speed_level
1,Bulbasaur,Grass,Poison,318,45,49,49,65,65,45,1,False,False,False,114,114,low,low,low
2,Ivysaur,Grass,Poison,405,60,62,63,80,80,60,1,False,False,False,142,143,medium,low,low
3,Venusaur,Grass,Poison,525,80,82,83,100,100,80,1,False,False,False,182,183,medium,medium,medium
3,Mega Venusaur,Grass,Poison,625,80,100,123,122,120,80,1,False,False,True,222,243,medium,medium,medium
4,Charmander,Fire,NaN,309,39,52,43,60,50,65,1,False,False,False,112,93,low,low,medium
5,Charmeleon,Fire,NaN,405,58,64,58,80,65,80,1,False,False,False,144,123,medium,low,medium
6,Charizard,Fire,Flying,534,78,84,78,109,85,100,1,False,False,False,193,163,medium,low,medium
6,Mega Charizard X,Fire,Dragon,634,78,130,111,130,85,100,1,False,False,True,260,196,high,medium,medium
6,Mega Charizard Y,Fire,Flying,634,78,104,78,159,115,100,1,False,False,True,263,193,high,medium,medium
7,Squirtle,Water,NaN,314,44,48,65,50,64,43,1,False,False,False,98,129,low,low,low
8,Wartortle,Water,NaN,405,59,63,80,65,80,58,1,False,False,False,128,160,low,low,low
9,Blastoise,Water,NaN,530,79,83,100,85,105,78,1,False,False,False,168,205,medium,medium,medium
9,Mega Blastoise,Water,NaN,630,79,103,120,135,115,78,1,False,False,True,238,235,medium,medium,medium
10,Caterpie,Bug,NaN,195,45,30,35,20,20,45,1,False,False,False,50,55,low,low,low
11,Metapod,Bug,NaN,205,50,20,55,25,25,30,1,False,False,False,45,80,low,low,low
12,Butterfree,Bug,Flying,395,60,45,50,90,80,70,1,False,False,False,135,130,medium,low,medium
13,Weedle,Bug,Poison,195,40,35,30,20,20,50,1,False,False,False,55,50,low,low,low
14,Kakuna,Bug,Poison,205,45,25,50,25,25,35,1,False,False,False,50,75,low,low,low
15,Beedrill,Bug,Poison,395,65,90,40,45,80,75,1,False,False,False,135,120,medium,low,medium
15,Mega Beedrill,Bug,Poison,495,65,150,40,15,80,145,1,False,False,True,165,120,medium,low,high
16,Pidgey,Normal,Flying,251,40,45,40,35,35,56,1,False,False,False,80,75,low,low,low
17,Pidgeotto,Normal,Flying,349,63,60,55,50,50,71,1,False,False,False,110,105,low,low,medium
18,Pidgeot,Normal,Flying,479,83,80,75,70,70,101,1,False,False,False,150,145,medium,low,medium
18,Mega Pidgeot,Normal,Flying,579,83,80,80,135,80,121,1,False,False,True,215,160,medium,low,medium
19,Rattata,Normal,NaN,253,30,56,35,25,35,72,1,False,False,False,81,70,low,low,medium
20,Raticate,Normal,NaN,413,55,81,60,50,70,97,1,False,False,False,131,130,low,low,medium
21,Spearow,Normal,Flying,262,40,60,30,31,31,70,1,False,False,False,91,61,low,low,medium
22,Fearow,Normal,Flying,442,65,90,65,61,61,100,1,False,False,False,151,126,medium,low,medium
23,Ekans,Poison,NaN,288,35,60,44,40,54,55,1,False,False,False,100,98,low,low,low
24,Arbok,Poison,NaN,438,60,85,69,65,79,80,1,False,False,False,150,148,medium,low,medium
25,Pikachu,Electric,NaN,320,35,55,40,50,50,90,1,False,False,False,105,90,low,low,medium
26,Raichu,Electric,NaN,485,60,90,55,90,80,110,1,False,False,False,180,135,medium,low,medium
27,Sandshrew,Ground,NaN,300,50,75,85,20,30,40,1,False,False,False,95,115,low,low,low
28,Sandslash,Ground,NaN,450,75,100,110,45,55,65,1,False,False,False,145,165,medium,low,medium
29,Nidoran♀,Poison,NaN,275,55,47,52,40,40,41,1,False,False,False,87,92,low,low,low
30,Nidorina,Poison,NaN,365,70,62,67,55,55,56,1,False,False,False,117,122,low,low,low
31,Nidoqueen,Poison,Ground,505,90,92,87,75,85,76,1,False,False,False,167,172,medium,low,medium
32,Nidoran♂,Poison,NaN,273,46,57,40,40,40,50,1,False,False,False,97,80,low,low,low
33,Nidorino,Poison,NaN,365,61,72,57,55,55,65,1,False,False,False,127,112,low,low,medium
34,Nidoking,Poison,Ground,505,81,102,77,85,75,85,1,False,False,False,187,152,medium,low,medium
35,Clefairy,Fairy,NaN,323,70,45,48,60,65,35,1,False,False,False,105,113,low,low,low
36,Clefable,Fairy,NaN,483,95,70,73,95,90,60,1,False,False,False,165,163,medium,low,low
37,Vulpix,Fire,NaN,299,38,41,40,50,65,65,1,False,False,False,91,105,low,low,medium
38,Ninetales,Fire,NaN,505,73,76,75,81,100,100,1,False,False,False,157,175,medium,low,medium
39,Jigglypuff,Normal,Fairy,270,115,45,20,45,25,20,1,False,False,False,90,45,low,low,low
40,Wigglytuff,Normal,Fairy,435,140,70,45,85,50,45,1,False,False,False,155,95,medium,low,low
41,Zubat,Poison,Flying,245,40,45,35,30,40,55,1,False,False,False,75,75,low,low,low
42,Golbat,Poison,Flying,455,75,80,70,65,75,90,1,False,False,False,145,145,medium,low,medium
43,Oddish,Grass,Poison,320,45,50,55,75,65,30,1,False,False,False,125,120,low,low,low
44,Gloom,Grass,Poison,395,60,65,70,85,75,40,1,False,False,False,150,145,medium,low,low
45,Vileplume,Grass,Poison,490,75,80,85,110,90,50,1,False,False,False,190,175,medium,low,low
46,Paras,Bug,Grass,285,35,70,55,45,55,25,1,False,False,False,115,110,low,low,low
47,Parasect,Bug,Grass,405,60,95,80,60,80,30,1,False,False,False,155,160,medium,low,low
48,Venonat,Bug,Poison,305,60,55,50,40,55,45,1,False,False,False,95,105,low,low,low
49,Venomoth,Bug,Poison,450,70,65,60,90,75,90,1,False,False,False,155,135,medium,low,medium
50,Diglett,Ground,NaN,265,10,55,25,35,45,95,1,False,False,False,90,70,low,low,medium
51,Dugtrio,Ground,NaN,405,35,80,50,50,70,120,1,False,False,False,130,120,low,low,medium
52,Meowth,Normal,NaN,290,40,45,35,40,40,90,1,False,False,False,85,75,low,low,medium
53,Persian,Normal,NaN,440,65,70,60,65,65,115,1,False,False,False,135,125,medium,low,medium
54,Psyduck,Water,NaN,320,50,52,48,65,50,55,1,False,False,False,117,98,low,low,low
55,Golduck,Water,NaN,500,80,82,78,95,80,85,1,False,False,False,177,158,medium,low,medium
56,Mankey,Fighting,NaN,305,40,80,35,35,45,70,1,False,False,False,115,80,low,low,medium
57,Primeape,Fighting,NaN,455,65,105,60,60,70,95,1,False,False,False,165,130,medium,low,medium
58,Growlithe,Fire,NaN,350,55,70,45,70,50,60,1,False,False,False,140,95,medium,low,low
59,Arcanine,Fire,NaN,555,90,110,80,100,80,95,1,False,False,False,210,160,medium,low,medium
60,Poliwag,Water,NaN,300,40,50,40,40,40,90,1,False,False,False,90,80,low,low,medium
61,Poliwhirl,Water,NaN,385,65,65,65,50,50,90,1,False,False,False,115,115,low,low,medium
62,Poliwrath,Water,Fighting,510,90,95,95,70,90,70,1,False,False,False,165,185,medium,medium,medium
63,Abra,Psychic,NaN,310,25,20,15,105,55,90,1,False,False,False,125,70,low,low,medium
64,Kadabra,Psychic,NaN,400,40,35,30,120,70,105,1,False,False,False,155,100,medium,low,medium
65,Alakazam,Psychic,NaN,500,55,50,45,135,95,120,1,False,False,False,185,140,medium,low,medium
65,Mega Alakazam,Psychic,NaN,590,55,50,65,175,95,150,1,False,False,True,225,160,medium,low,high
66,Machop,Fighting,NaN,305,70,80,50,35,35,35,1,False,False,False,115,85,low,low,low
67,Machoke,Fighting,NaN,405,80,100,70,50,60,45,1,False,False,False,150,130,medium,low,low
68,Machamp,Fighting,NaN,505,90,130,80,65,85,55,1,False,False,False,195,165,medium,low,low
69,Bellsprout,Grass,Poison,300,50,75,35,70,30,40,1,False,False,False,145,65,medium,low,low
70,Weepinbell,Grass,Poison,390,65,90,50,85,45,55,1,False,False,False,175,95,medium,low,low
71,Victreebel,Grass,Poison,490,80,105,65,100,70,70,1,False,False,False,205,135,medium,low,medium
72,Tentacool,Water,Poison,335,40,40,35,50,100,70,1,False,False,False,90,135,low,low,medium
73,Tentacruel,Water,Poison,515,80,70,65,80,120,100,1,False,False,False,150,185,medium,medium,medium
74,Geodude,Rock,Ground,300,40,80,100,30,30,20,1,False,False,False,110,130,low,low,low
75,Graveler,Rock,Ground,390,55,95,115,45,45,35,1,False,False,False,140,160,medium,low,low
76,Golem,Rock,Ground,495,80,120,130,55,65,45,1,False,False,False,175,195,medium,medium,low
77,Ponyta,Fire,NaN,410,50,85,55,65,65,90,1,False,False,False,150,120,medium,low,medium
78,Rapidash,Fire,NaN,500,65,100,70,80,80,105,1,False,False,False,180,150,medium,low,medium
79,Slowpoke,Water,Psychic,315,90,65,65,40,40,15,1,False,False,False,105,105,low,low,low
80,Slowbro,Water,Psychic,490,95,75,110,100,80,30,1,False,False,False,175,190,medium,medium,low
80,Mega Slowbro,Water,Psychic,590,95,75,180,130,80,30,1,False,False,True,205,260,medium,medium,low
81,Magnemite,Electric,Steel,325,25,35,70,95,55,45,1,False,False,False,130,125,low,low,low
82,Magneton,Electric,Steel,465,50,60,95,120,70,70,1,False,False,False,180,165,medium,low,medium
83,Farfetch'd,Normal,Flying,352,52,65,55,58,62,60,1,False,False,False,123,117,low,low,low
84,Doduo,Normal,Flying,310,35,85,45,35,35,75,1,False,False,False,120,80,low,low,medium
85,Dodrio,Normal,Flying,460,60,110,70,60,60,100,1,False,False,False,170,130,medium,low,medium
86,Seel,Water,NaN,325,65,45,55,45,70,45,1,False,False,False,90,125,low,low,low
87,Dewgong,Water,Ice,475,90,70,80,70,95,70,1,False,False,False,140,175,medium,low,medium
88,Grimer,Poison,NaN,325,80,80,50,40,50,25,1,False,False,False,120,100,low,low,low
89,Muk,Poison,NaN,500,105,105,75,65,100,50,1,False,False,False,170,175,medium,low,low
90,Shellder,Water,NaN,305,30,65,100,45,25,40,1,False,False,False,110,125,low,low,low
91,Cloyster,Water,Ice,525,50,95,180,85,45,70,1,False,False,False,180,225,medium,medium,medium
92,Gastly,Ghost,Poison,310,30,35,30,100,35,80,1,False,False,False,135,65,medium,low,medium
93,Haunter,Ghost,Poison,405,45,50,45,115,55,95,1,False,False,False,165,100,medium,low,medium
94,Gengar,Ghost,Poison,500,60,65,60,130,75,110,1,False,False,False,195,135,medium,low,medium
94,Mega Gengar,Ghost,Poison,600,60,65,80,170,95,130,1,False,False,True,235,175,medium,low,high
95,Onix,Rock,Ground,385,35,45,160,30,45,70,1,False,False,False,75,205,low,medium,medium
96,Drowzee,Psychic,NaN,328,60,48,45,43,90,42,1,False,False,False,91,135,low,low,low
97,Hypno,Psychic,NaN,483,85,73,70,73,115,67,1,False,False,False,146,185,medium,medium,medium
98,Krabby,Water,NaN,325,30,105,90,25,25,50,1,False,False,False,130,115,low,low,low
99,Kingler,Water,NaN,475,55,130,115,50,50,75,1,False,False,False,180,165,medium,low,medium
100,Voltorb,Electric,NaN,330,40,30,50,55,55,100,1,False,False,False,85,105,low,low,medium
101,Electrode,Electric,NaN,480,60,50,70,80,80,140,1,False,False,False,130,150,low,low,high
102,Exeggcute,Grass,Psychic,325,60,40,80,60,45,40,1,False,False,False,100,125,low,low,low
103,Exeggutor,Grass,Psychic,520,95,95,85,125,65,55,1,False,False,False,220,150,medium,low,low
104,Cubone,Ground,NaN,320,50,50,95,40,50,35,1,False,False,False,90,145,low,low,low
105,Marowak,Ground,NaN,425,60,80,110,50,80,45,1,False,False,False,130,190,low,medium,low
106,Hitmonlee,Fighting,NaN,455,50,120,53,35,110,87,1,False,False,False,155,163,medium,low,medium
107,Hitmonchan,Fighting,NaN,455,50,105,79,35,110,76,1,False,False,False,140,189,medium,medium,medium
108,Lickitung,Normal,NaN,385,90,55,75,60,75,30,1,False,False,False,115,150,low,low,low
109,Koffing,Poison,NaN,340,40,65,95,60,45,35,1,False,False,False,125,140,low,low,low
110,Weezing,Poison,NaN,490,65,90,120,85,70,60,1,False,False,False,175,190,medium,medium,low
111,Rhyhorn,Ground,Rock,345,80,85,95,30,30,25,1,False,False,False,115,125,low,low,low
112,Rhydon,Ground,Rock,485,105,130,120,45,45,40,1,False,False,False,175,165,medium,low,low
113,Chansey,Normal,NaN,450,250,5,5,35,105,50,1,False,False,False,40,110,low,low,low
114,Tangela,Grass,NaN,435,65,55,115,100,40,60,1,False,False,False,155,155,medium,low,low
115,Kangaskhan,Normal,NaN,490,105,95,80,40,80,90,1,False,False,False,135,160,medium,low,medium
115,Mega Kangaskhan,Normal,NaN,590,105,125,100,60,100,100,1,False,False,True,185,200,medium,medium,medium
116,Horsea,Water,NaN,295,30,40,70,70,25,60,1,False,False,False,110,95,low,low,low
117,Seadra,Water,NaN,440,55,65,95,95,45,85,1,False,False,False,160,140,medium,low,medium
118,Goldeen,Water,NaN,320,45,67,60,35,50,63,1,False,False,False,102,110,low,low,low
119,Seaking,Water,NaN,450,80,92,65,65,80,68,1,False,False,False,157,145,medium,low,medium
120,Staryu,Water,NaN,340,30,45,55,70,55,85,1,False,False,False,115,110,low,low,medium
121,Starmie,Water,Psychic,520,60,75,85,100,85,115,1,False,False,False,175,170,medium,low,medium
122,Mr. Mime,Psychic,Fairy,460,40,45,65,100,120,90,1,False,False,False,145,185,medium,medium,medium
123,Scyther,Bug,Flying,500,70,110,80,55,80,105,1,False,False,False,165,160,medium,low,medium
124,Jynx,Ice,Psychic,455,65,50,35,115,95,95,1,False,False,False,165,130,medium,low,medium
125,Electabuzz,Electric,NaN,490,65,83,57,95,85,105,1,False,False,False,178,142,medium,low,medium
126,Magmar,Fire,NaN,495,65,95,57,100,85,93,1,False,False,False,195,142,medium,low,medium
127,Pinsir,Bug,NaN,500,65,125,100,55,70,85,1,False,False,False,180,170,medium,low,medium
127,Mega Pinsir,Bug,Flying,600,65,155,120,65,90,105,1,False,False,True,220,210,medium,medium,medium
128,Tauros,Normal,NaN,490,75,100,95,40,70,110,1,False,False,False,140,165,medium,low,medium
129,Magikarp,Water,NaN,200,20,10,55,15,20,80,1,False,False,False,25,75,low,low,medium
130,Gyarados,Water,Flying,540,95,125,79,60,100,81,1,False,False,False,185,179,medium,medium,medium
130,Mega Gyarados,Water,Dark,640,95,155,109,70,130,81,1,False,False,True,225,239,medium,medium,medium
131,Lapras,Water,Ice,535,130,85,80,85,95,60,1,False,False,False,170,175,medium,low,low
132,Ditto,Normal,NaN,288,48,48,48,48,48,48,1,False,False,False,96,96,low,low,low
133,Eevee,Normal,NaN,325,55,55,50,45,65,55,1,False,False,False,100,115,low,low,low
134,Vaporeon,Water,NaN,525,130,65,60,110,95,65,1,False,False,False,175,155,medium,low,medium
135,Jolteon,Electric,NaN,525,65,65,60,110,95,130,1,False,False,False,175,155,medium,low,high
136,Flareon,Fire,NaN,525,65,130,60,95,110,65,1,False,False,False,225,170,medium,low,medium
137,Porygon,Normal,NaN,395,65,60,70,85,75,40,1,False,False,False,145,145,medium,low,low
138,Omanyte,Rock,Water,355,35,40,100,90,55,35,1,False,False,False,130,155,low,low,low
139,Omastar,Rock,Water,495,70,60,125,115,70,55,1,False,False,False,175,195,medium,medium,low
140,Kabuto,Rock,Water,355,30,80,90,55,45,55,1,False,False,False,135,135,medium,low,low
141,Kabutops,Rock,Water,495,60,115,105,65,70,80,1,False,False,False,180,175,medium,low,medium
142,Aerodactyl,Rock,Flying,515,80,105,65,60,75,130,1,False,False,False,165,140,medium,low,high
142,Mega Aerodactyl,Rock,Flying,615,80,135,85,70,95,150,1,False,False,True,205,180,medium,medium,high
143,Snorlax,Normal,NaN,540,160,110,65,65,110,30,1,False,False,False,175,175,medium,low,low
144,Articuno,Ice,Flying,580,90,85,100,95,125,85,1,True,False,False,180,225,medium,medium,medium
145,Zapdos,Electric,Flying,580,90,90,85,125,90,100,1,True,False,False,215,175,medium,low,medium
146,Moltres,Fire,Flying,580,90,100,90,125,85,90,1,True,False,False,225,175,medium,low,medium
147,Dratini,Dragon,NaN,300,41,64,45,50,50,50,1,False,False,False,114,95,low,low,low
148,Dragonair,Dragon,NaN,420,61,84,65,70,70,70,1,False,False,False,154,135,medium,low,medium
149,Dragonite,Dragon,Flying,600,91,134,95,100,100,80,1,False,False,False,234,195,medium,medium,medium
150,Mewtwo,Psychic,NaN,680,106,110,90,154,90,130,1,True,False,False,264,180,high,medium,high
150,Mega Mewtwo X,Psychic,Fighting,780,106,190,100,154,100,130,1,True,False,True,344,200,high,medium,high
150,Mega Mewtwo Y,Psychic,NaN,780,106,150,70,194,120,140,1,True,False,True,344,190,high,medium,high
151,Mew,Psychic,NaN,600,100,100,100,100,100,100,1,False,False,False,200,200,medium,medium,medium
152,Chikorita,Grass,NaN,318,45,49,65,49,65,45,2,False,False,False,98,130,low,low,low
153,Bayleef,Grass,NaN,405,60,62,80,63,80,60,2,False,False,False,125,160,low,low,low
154,Meganium,Grass,NaN,525,80,82,100,83,100,80,2,False,False,False,165,200,medium,medium,medium
155,Cyndaquil,Fire,NaN,309,39,52,43,60,50,65,2,False,False,False,112,93,low,low,medium
156,Quilava,Fire,NaN,405,58,64,58,80,65,80,2,False,False,False,144,123,medium,low,medium
157,Typhlosion,Fire,NaN,534,78,84,78,109,85,100,2,False,False,False,193,163,medium,low,medium
158,Totodile,Water,NaN,314,50,65,64,44,48,43,2,False,False,False,109,112,low,low,low
159,Croconaw,Water,NaN,405,65,80,80,59,63,58,2,False,False,False,139,143,medium,low,low
160,Feraligatr,Water,NaN,530,85,105,100,79,83,78,2,False,False,False,184,183,medium,medium,medium
161,Sentret,Normal,NaN,215,35,46,34,35,45,20,2,False,False,False,81,79,low,low,low
162,Furret,Normal,NaN,415,85,76,64,45,55,90,2,False,False,False,121,119,low,low,medium
163,Hoothoot,Normal,Flying,262,60,30,30,36,56,50,2,False,False,False,66,86,low,low,low
164,Noctowl,Normal,Flying,442,100,50,50,76,96,70,2,False,False,False,126,146,low,low,medium
165,Ledyba,Bug,Flying,265,40,20,30,40,80,55,2,False,False,False,60,110,low,low,low
166,Ledian,Bug,Flying,390,55,35,50,55,110,85,2,False,False,False,90,160,low,low,medium
167,Spinarak,Bug,Poison,250,40,60,40,40,40,30,2,False,False,False,100,80,low,low,low
168,Ariados,Bug,Poison,390,70,90,70,60,60,40,2,False,False,False,150,130,medium,low,low
169,Crobat,Poison,Flying,535,85,90,80,70,80,130,2,False,False,False,160,160,medium,low,high
170,Chinchou,Water,Electric,330,75,38,38,56,56,67,2,False,False,False,94,94,low,low,medium
171,Lanturn,Water,Electric,460,125,58,58,76,76,67,2,False,False,False,134,134,medium,low,medium
172,Pichu,Electric,NaN,205,20,40,15,35,35,60,2,False,False,False,75,50,low,low,low
173,Cleffa,Fairy,NaN,218,50,25,28,45,55,15,2,False,False,False,70,83,low,low,low
174,Igglybuff,Normal,Fairy,210,90,30,15,40,20,15,2,False,False,False,70,35,low,low,low
175,Togepi,Fairy,NaN,245,35,20,65,40,65,20,2,False,False,False,60,130,low,low,low
176,Togetic,Fairy,Flying,405,55,40,85,80,105,40,2,False,False,False,120,190,low,medium,low
177,Natu,Psychic,Flying,320,40,50,45,70,45,70,2,False,False,False,120,90,low,low,medium
178,Xatu,Psychic,Flying,470,65,75,70,95,70,95,2,False,False,False,170,140,medium,low,medium
179,Mareep,Electric,NaN,280,55,40,40,65,45,35,2,False,False,False,105,85,low,low,low
180,Flaaffy,Electric,NaN,365,70,55,55,80,60,45,2,False,False,False,135,115,medium,low,low
181,Ampharos,Electric,NaN,510,90,75,85,115,90,55,2,False,False,False,190,175,medium,low,low
181,Mega Ampharos,Electric,Dragon,610,90,95,105,165,110,45,2,False,False,True,260,215,high,medium,low
182,Bellossom,Grass,NaN,490,75,80,95,90,100,50,2,False,False,False,170,195,medium,medium,low
183,Marill,Water,Fairy,250,70,20,50,20,50,40,2,False,False,False,40,100,low,low,low
184,Azumarill,Water,Fairy,420,100,50,80,60,80,50,2,False,False,False,110,160,low,low,low
185,Sudowoodo,Rock,NaN,410,70,100,115,30,65,30,2,False,False,False,130,180,low,medium,low
186,Politoed,Water,NaN,500,90,75,75,90,100,70,2,False,False,False,165,175,medium,low,medium
187,Hoppip,Grass,Flying,250,35,35,40,35,55,50,2,False,False,False,70,95,low,low,low
188,Skiploom,Grass,Flying,340,55,45,50,45,65,80,2,False,False,False,90,115,low,low,medium
189,Jumpluff,Grass,Flying,460,75,55,70,55,95,110,2,False,False,False,110,165,low,low,medium
190,Aipom,Normal,NaN,360,55,70,55,40,55,85,2,False,False,False,110,110,low,low,medium
191,Sunkern,Grass,NaN,180,30,30,30,30,30,30,2,False,False,False,60,60,low,low,low
192,Sunflora,Grass,NaN,425,75,75,55,105,85,30,2,False,False,False,180,140,medium,low,low
193,Yanma,Bug,Flying,390,65,65,45,75,45,95,2,False,False,False,140,90,medium,low,medium
194,Wooper,Water,Ground,210,55,45,45,25,25,15,2,False,False,False,70,70,low,low,low
195,Quagsire,Water,Ground,430,95,85,85,65,65,35,2,False,False,False,150,150,medium,low,low
196,Espeon,Psychic,NaN,525,65,65,60,130,95,110,2,False,False,False,195,155,medium,low,medium
197,Umbreon,Dark,NaN,525,95,65,110,60,130,65,2,False,False,False,125,240,low,medium,medium
198,Murkrow,Dark,Flying,405,60,85,42,85,42,91,2,False,False,False,170,84,medium,low,medium
199,Slowking,Water,Psychic,490,95,75,80,100,110,30,2,False,False,False,175,190,medium,medium,low
200,Misdreavus,Ghost,NaN,435,60,60,60,85,85,85,2,False,False,False,145,145,medium,low,medium
201,Unown,Psychic,NaN,336,48,72,48,72,48,48,2,False,False,False,144,96,medium,low,low
202,Wobbuffet,Psychic,NaN,405,190,33,58,33,58,33,2,False,False,False,66,116,low,low,low
203,Girafarig,Normal,Psychic,455,70,80,65,90,65,85,2,False,False,False,170,130,medium,low,medium
204,Pineco,Bug,NaN,290,50,65,90,35,35,15,2,False,False,False,100,125,low,low,low
205,Forretress,Bug,Steel,465,75,90,140,60,60,40,2,False,False,False,150,200,medium,medium,low
206,Dunsparce,Normal,NaN,415,100,70,70,65,65,45,2,False,False,False,135,135,medium,low,low
207,Gligar,Ground,Flying,430,65,75,105,35,65,85,2,False,False,False,110,170,low,low,medium
208,Steelix,Steel,Ground,510,75,85,200,55,65,30,2,False,False,False,140,265,medium,medium,low
208,Mega Steelix,Steel,Ground,610,75,125,230,55,95,30,2,False,False,True,180,325,medium,high,low
209,Snubbull,Fairy,NaN,300,60,80,50,40,40,30,2,False,False,False,120,90,low,low,low
210,Granbull,Fairy,NaN,450,90,120,75,60,60,45,2,False,False,False,180,135,medium,low,low
211,Qwilfish,Water,Poison,430,65,95,75,55,55,85,2,False,False,False,150,130,medium,low,medium
212,Scizor,Bug,Steel,500,70,130,100,55,80,65,2,False,False,False,185,180,medium,medium,medium
212,Mega Scizor,Bug,Steel,600,70,150,140,65,100,75,2,False,False,True,215,240,medium,medium,medium
213,Shuckle,Bug,Rock,505,20,10,230,10,230,5,2,False,False,False,20,460,low,high,low
214,Heracross,Bug,Fighting,500,80,125,75,40,95,85,2,False,False,False,165,170,medium,low,medium
214,Mega Heracross,Bug,Fighting,600,80,185,115,40,105,75,2,False,False,True,225,220,medium,medium,medium
215,Sneasel,Dark,Ice,430,55,95,55,35,75,115,2,False,False,False,130,130,low,low,medium
216,Teddiursa,Normal,NaN,330,60,80,50,50,50,40,2,False,False,False,130,100,low,low,low
217,Ursaring,Normal,NaN,500,90,130,75,75,75,55,2,False,False,False,205,150,medium,low,low
218,Slugma,Fire,NaN,250,40,40,40,70,40,20,2,False,False,False,110,80,low,low,low
219,Magcargo,Fire,Rock,410,50,50,120,80,80,30,2,False,False,False,130,200,low,medium,low
220,Swinub,Ice,Ground,250,50,50,40,30,30,50,2,False,False,False,80,70,low,low,low
221,Piloswine,Ice,Ground,450,100,100,80,60,60,50,2,False,False,False,160,140,medium,low,low
222,Corsola,Water,Rock,380,55,55,85,65,85,35,2,False,False,False,120,170,low,low,low
223,Remoraid,Water,NaN,300,35,65,35,65,35,65,2,False,False,False,130,70,low,low,medium
224,Octillery,Water,NaN,480,75,105,75,105,75,45,2,False,False,False,210,150,medium,low,low
225,Delibird,Ice,Flying,330,45,55,45,65,45,75,2,False,False,False,120,90,low,low,medium
226,Mantine,Water,Flying,465,65,40,70,80,140,70,2,False,False,False,120,210,low,medium,medium
227,Skarmory,Steel,Flying,465,65,80,140,40,70,70,2,False,False,False,120,210,low,medium,medium
228,Houndour,Dark,Fire,330,45,60,30,80,50,65,2,False,False,False,140,80,medium,low,medium
229,Houndoom,Dark,Fire,500,75,90,50,110,80,95,2,False,False,False,200,130,medium,low,medium
229,Mega Houndoom,Dark,Fire,600,75,90,90,140,90,115,2,False,False,True,230,180,medium,medium,medium
230,Kingdra,Water,Dragon,540,75,95,95,95,95,85,2,False,False,False,190,190,medium,medium,medium
231,Phanpy,Ground,NaN,330,90,60,60,40,40,40,2,False,False,False,100,100,low,low,low
232,Donphan,Ground,NaN,500,90,120,120,60,60,50,2,False,False,False,180,180,medium,medium,low
233,Porygon2,Normal,NaN,515,85,80,90,105,95,60,2,False,False,False,185,185,medium,medium,low
234,Stantler,Normal,NaN,465,73,95,62,85,65,85,2,False,False,False,180,127,medium,low,medium
235,Smeargle,Normal,NaN,250,55,20,35,20,45,75,2,False,False,False,40,80,low,low,medium
236,Tyrogue,Fighting,NaN,210,35,35,35,35,35,35,2,False,False,False,70,70,low,low,low
237,Hitmontop,Fighting,NaN,455,50,95,95,35,110,70,2,False,False,False,130,205,low,medium,medium
238,Smoochum,Ice,Psychic,305,45,30,15,85,65,65,2,False,False,False,115,80,low,low,medium
239,Elekid,Electric,NaN,360,45,63,37,65,55,95,2,False,False,False,128,92,low,low,medium
240,Magby,Fire,NaN,365,45,75,37,70,55,83,2,False,False,False,145,92,medium,low,medium
241,Miltank,Normal,NaN,490,95,80,105,40,70,100,2,False,False,False,120,175,low,low,medium
242,Blissey,Normal,NaN,540,255,10,10,75,135,55,2,False,False,False,85,145,low,low,low
243,Raikou,Electric,NaN,580,90,85,75,115,100,115,2,True,False,False,200,175,medium,low,medium
244,Entei,Fire,NaN,580,115,115,85,90,75,100,2,True,False,False,205,160,medium,low,medium
245,Suicune,Water,NaN,580,100,75,115,90,115,85,2,True,False,False,165,230,medium,medium,medium
246,Larvitar,Rock,Ground,300,50,64,50,45,50,41,2,False,False,False,109,100,low,low,low
247,Pupitar,Rock,Ground,410,70,84,70,65,70,51,2,False,False,False,149,140,medium,low,low
248,Tyranitar,Rock,Dark,600,100,134,110,95,100,61,2,False,False,False,229,210,medium,medium,low
248,Mega Tyranitar,Rock,Dark,700,100,164,150,95,120,71,2,False,False,True,259,270,high,medium,medium
249,Lugia,Psychic,Flying,680,106,90,130,90,154,110,2,True,False,False,180,284,medium,medium,medium
250,Ho-oh,Fire,Flying,680,106,130,90,110,154,90,2,True,False,False,240,244,medium,medium,medium
251,Celebi,Psychic,Grass,600,100,100,100,100,100,100,2,False,False,False,200,200,medium,medium,medium
252,Treecko,Grass,NaN,310,40,45,35,65,55,70,3,False,False,False,110,90,low,low,medium
253,Grovyle,Grass,NaN,405,50,65,45,85,65,95,3,False,False,False,150,110,medium,low,medium
254,Sceptile,Grass,NaN,530,70,85,65,105,85,120,3,False,False,False,190,150,medium,low,medium
254,Mega Sceptile,Grass,Dragon,630,70,110,75,145,85,145,3,False,False,True,255,160,high,low,high
255,Torchic,Fire,NaN,310,45,60,40,70,50,45,3,False,False,False,130,90,low,low,low
256,Combusken,Fire,Fighting,405,60,85,60,85,60,55,3,False,False,False,170,120,medium,low,low
257,Blaziken,Fire,Fighting,530,80,120,70,110,70,80,3,False,False,False,230,140,medium,low,medium
257,Mega Blaziken,Fire,Fighting,630,80,160,80,130,80,100,3,False,False,True,290,160,high,low,medium
258,Mudkip,Water,NaN,310,50,70,50,50,50,40,3,False,False,False,120,100,low,low,low
259,Marshtomp,Water,Ground,405,70,85,70,60,70,50,3,False,False,False,145,140,medium,low,low
260,Swampert,Water,Ground,535,100,110,90,85,90,60,3,False,False,False,195,180,medium,medium,low
260,Mega Swampert,Water,Ground,635,100,150,110,95,110,70,3,False,False,True,245,220,medium,medium,medium
261,Poochyena,Dark,NaN,220,35,55,35,30,30,35,3,False,False,False,85,65,low,low,low
262,Mightyena,Dark,NaN,420,70,90,70,60,60,70,3,False,False,False,150,130,medium,low,medium
263,Zigzagoon,Normal,NaN,240,38,30,41,30,41,60,3,False,False,False,60,82,low,low,low
264,Linoone,Normal,NaN,420,78,70,61,50,61,100,3,False,False,False,120,122,low,low,medium
265,Wurmple,Bug,NaN,195,45,45,35,20,30,20,3,False,False,False,65,65,low,low,low
266,Silcoon,Bug,NaN,205,50,35,55,25,25,15,3,False,False,False,60,80,low,low,low
267,Beautifly,Bug,Flying,395,60,70,50,100,50,65,3,False,False,False,170,100,medium,low,medium
268,Cascoon,Bug,NaN,205,50,35,55,25,25,15,3,False,False,False,60,80,low,low,low
269,Dustox,Bug,Poison,385,60,50,70,50,90,65,3,False,False,False,100,160,low,low,medium
270,Lotad,Water,Grass,220,40,30,30,40,50,30,3,False,False,False,70,80,low,low,low
271,Lombre,Water,Grass,340,60,50,50,60,70,50,3,False,False,False,110,120,low,low,low
272,Ludicolo,Water,Grass,480,80,70,70,90,100,70,3,False,False,False,160,170,medium,low,medium
273,Seedot,Grass,NaN,220,40,40,50,30,30,30,3,False,False,False,70,80,low,low,low
274,Nuzleaf,Grass,Dark,340,70,70,40,60,40,60,3,False,False,False,130,80,low,low,low
275,Shiftry,Grass,Dark,480,90,100,60,90,60,80,3,False,False,False,190,120,medium,low,medium
276,Taillow,Normal,Flying,270,40,55,30,30,30,85,3,False,False,False,85,60,low,low,medium
277,Swellow,Normal,Flying,430,60,85,60,50,50,125,3,False,False,False,135,110,medium,low,high
278,Wingull,Water,Flying,270,40,30,30,55,30,85,3,False,False,False,85,60,low,low,medium
279,Pelipper,Water,Flying,430,60,50,100,85,70,65,3,False,False,False,135,170,medium,low,medium
280,Ralts,Psychic,Fairy,198,28,25,25,45,35,40,3,False,False,False,70,60,low,low,low
281,Kirlia,Psychic,Fairy,278,38,35,35,65,55,50,3,False,False,False,100,90,low,low,low
282,Gardevoir,Psychic,Fairy,518,68,65,65,125,115,80,3,False,False,False,190,180,medium,medium,medium
282,Mega Gardevoir,Psychic,Fairy,618,68,85,65,165,135,100,3,False,False,True,250,200,high,medium,medium
283,Surskit,Bug,Water,269,40,30,32,50,52,65,3,False,False,False,80,84,low,low,medium
284,Masquerain,Bug,Flying,414,70,60,62,80,82,60,3,False,False,False,140,144,medium,low,low
285,Shroomish,Grass,NaN,295,60,40,60,40,60,35,3,False,False,False,80,120,low,low,low
286,Breloom,Grass,Fighting,460,60,130,80,60,60,70,3,False,False,False,190,140,medium,low,medium
287,Slakoth,Normal,NaN,280,60,60,60,35,35,30,3,False,False,False,95,95,low,low,low
288,Vigoroth,Normal,NaN,440,80,80,80,55,55,90,3,False,False,False,135,135,medium,low,medium
289,Slaking,Normal,NaN,670,150,160,100,95,65,100,3,False,False,False,255,165,high,low,medium
290,Nincada,Bug,Ground,266,31,45,90,30,30,40,3,False,False,False,75,120,low,low,low
291,Ninjask,Bug,Flying,456,61,90,45,50,50,160,3,False,False,False,140,95,medium,low,high
292,Shedinja,Bug,Ghost,236,1,90,45,30,30,40,3,False,False,False,120,75,low,low,low
293,Whismur,Normal,NaN,240,64,51,23,51,23,28,3,False,False,False,102,46,low,low,low
294,Loudred,Normal,NaN,360,84,71,43,71,43,48,3,False,False,False,142,86,medium,low,low
295,Exploud,Normal,NaN,490,104,91,63,91,73,68,3,False,False,False,182,136,medium,low,medium
296,Makuhita,Fighting,NaN,237,72,60,30,20,30,25,3,False,False,False,80,60,low,low,low
297,Hariyama,Fighting,NaN,474,144,120,60,40,60,50,3,False,False,False,160,120,medium,low,low
298,Azurill,Normal,Fairy,190,50,20,40,20,40,20,3,False,False,False,40,80,low,low,low
299,Nosepass,Rock,NaN,375,30,45,135,45,90,30,3,False,False,False,90,225,low,medium,low
300,Skitty,Normal,NaN,260,50,45,45,35,35,50,3,False,False,False,80,80,low,low,low
301,Delcatty,Normal,NaN,380,70,65,65,55,55,70,3,False,False,False,120,120,low,low,medium
302,Sableye,Dark,Ghost,380,50,75,75,65,65,50,3,False,False,False,140,140,medium,low,low
302,Mega Sableye,Dark,Ghost,480,50,85,125,85,115,20,3,False,False,True,170,240,medium,medium,low
303,Mawile,Steel,Fairy,380,50,85,85,55,55,50,3,False,False,False,140,140,medium,low,low
303,Mega Mawile,Steel,Fairy,480,50,105,125,55,95,50,3,False,False,True,160,220,medium,medium,low
304,Aron,Steel,Rock,330,50,70,100,40,40,30,3,False,False,False,110,140,low,low,low
305,Lairon,Steel,Rock,430,60,90,140,50,50,40,3,False,False,False,140,190,medium,medium,low
306,Aggron,Steel,Rock,530,70,110,180,60,60,50,3,False,False,False,170,240,medium,medium,low
306,Mega Aggron,Steel,NaN,630,70,140,230,60,80,50,3,False,False,True,200,310,medium,medium,low
307,Meditite,Fighting,Psychic,280,30,40,55,40,55,60,3,False,False,False,80,110,low,low,low
308,Medicham,Fighting,Psychic,410,60,60,75,60,75,80,3,False,False,False,120,150,low,low,medium
308,Mega Medicham,Fighting,Psychic,510,60,100,85,80,85,100,3,False,False,True,180,170,medium,low,medium
309,Electrike,Electric,NaN,295,40,45,40,65,40,65,3,False,False,False,110,80,low,low,medium
310,Manectric,Electric,NaN,475,70,75,60,105,60,105,3,False,False,False,180,120,medium,low,medium
310,Mega Manectric,Electric,NaN,575,70,75,80,135,80,135,3,False,False,True,210,160,medium,low,high
311,Plusle,Electric,NaN,405,60,50,40,85,75,95,3,False,False,False,135,115,medium,low,medium
312,Minun,Electric,NaN,405,60,40,50,75,85,95,3,False,False,False,115,135,low,low,medium
313,Volbeat,Bug,NaN,400,65,73,55,47,75,85,3,False,False,False,120,130,low,low,medium
314,Illumise,Bug,NaN,400,65,47,55,73,75,85,3,False,False,False,120,130,low,low,medium
315,Roselia,Grass,Poison,400,50,60,45,100,80,65,3,False,False,False,160,125,medium,low,medium
316,Gulpin,Poison,NaN,302,70,43,53,43,53,40,3,False,False,False,86,106,low,low,low
317,Swalot,Poison,NaN,467,100,73,83,73,83,55,3,False,False,False,146,166,medium,low,low
318,Carvanha,Water,Dark,305,45,90,20,65,20,65,3,False,False,False,155,40,medium,low,medium
319,Sharpedo,Water,Dark,460,70,120,40,95,40,95,3,False,False,False,215,80,medium,low,medium
319,Mega Sharpedo,Water,Dark,560,70,140,70,110,65,105,3,False,False,True,250,135,high,low,medium
320,Wailmer,Water,NaN,400,130,70,35,70,35,60,3,False,False,False,140,70,medium,low,low
321,Wailord,Water,NaN,500,170,90,45,90,45,60,3,False,False,False,180,90,medium,low,low
322,Numel,Fire,Ground,305,60,60,40,65,45,35,3,False,False,False,125,85,low,low,low
323,Camerupt,Fire,Ground,460,70,100,70,105,75,40,3,False,False,False,205,145,medium,low,low
323,Mega Camerupt,Fire,Ground,560,70,120,100,145,105,20,3,False,False,True,265,205,high,medium,low
324,Torkoal,Fire,NaN,470,70,85,140,85,70,20,3,False,False,False,170,210,medium,medium,low
325,Spoink,Psychic,NaN,330,60,25,35,70,80,60,3,False,False,False,95,115,low,low,low
326,Grumpig,Psychic,NaN,470,80,45,65,90,110,80,3,False,False,False,135,175,medium,low,medium
327,Spinda,Normal,NaN,360,60,60,60,60,60,60,3,False,False,False,120,120,low,low,low
328,Trapinch,Ground,NaN,290,45,100,45,45,45,10,3,False,False,False,145,90,medium,low,low
329,Vibrava,Ground,Dragon,340,50,70,50,50,50,70,3,False,False,False,120,100,low,low,medium
330,Flygon,Ground,Dragon,520,80,100,80,80,80,100,3,False,False,False,180,160,medium,low,medium
331,Cacnea,Grass,NaN,335,50,85,40,85,40,35,3,False,False,False,170,80,medium,low,low
332,Cacturne,Grass,Dark,475,70,115,60,115,60,55,3,False,False,False,230,120,medium,low,low
333,Swablu,Normal,Flying,310,45,40,60,40,75,50,3,False,False,False,80,135,low,low,low
334,Altaria,Dragon,Flying,490,75,70,90,70,105,80,3,False,False,False,140,195,medium,medium,medium
334,Mega Altaria,Dragon,Fairy,590,75,110,110,110,105,80,3,False,False,True,220,215,medium,medium,medium
335,Zangoose,Normal,NaN,458,73,115,60,60,60,90,3,False,False,False,175,120,medium,low,medium
336,Seviper,Poison,NaN,458,73,100,60,100,60,65,3,False,False,False,200,120,medium,low,medium
337,Lunatone,Rock,Psychic,440,70,55,65,95,85,70,3,False,False,False,150,150,medium,low,medium
338,Solrock,Rock,Psychic,440,70,95,85,55,65,70,3,False,False,False,150,150,medium,low,medium
339,Barboach,Water,Ground,288,50,48,43,46,41,60,3,False,False,False,94,84,low,low,low
340,Whiscash,Water,Ground,468,110,78,73,76,71,60,3,False,False,False,154,144,medium,low,low
341,Corphish,Water,NaN,308,43,80,65,50,35,35,3,False,False,False,130,100,low,low,low
342,Crawdaunt,Water,Dark,468,63,120,85,90,55,55,3,False,False,False,210,140,medium,low,low
343,Baltoy,Ground,Psychic,300,40,40,55,40,70,55,3,False,False,False,80,125,low,low,low
344,Claydol,Ground,Psychic,500,60,70,105,70,120,75,3,False,False,False,140,225,medium,medium,medium
345,Lileep,Rock,Grass,355,66,41,77,61,87,23,3,False,False,False,102,164,low,low,low
346,Cradily,Rock,Grass,495,86,81,97,81,107,43,3,False,False,False,162,204,medium,medium,low
347,Anorith,Rock,Bug,355,45,95,50,40,50,75,3,False,False,False,135,100,medium,low,medium
348,Armaldo,Rock,Bug,495,75,125,100,70,80,45,3,False,False,False,195,180,medium,medium,low
349,Feebas,Water,NaN,200,20,15,20,10,55,80,3,False,False,False,25,75,low,low,medium
350,Milotic,Water,NaN,540,95,60,79,100,125,81,3,False,False,False,160,204,medium,medium,medium
351,Castform,Normal,NaN,420,70,70,70,70,70,70,3,False,False,False,140,140,medium,low,medium
352,Kecleon,Normal,NaN,440,60,90,70,60,120,40,3,False,False,False,150,190,medium,medium,low
353,Shuppet,Ghost,NaN,295,44,75,35,63,33,45,3,False,False,False,138,68,medium,low,low
354,Banette,Ghost,NaN,455,64,115,65,83,63,65,3,False,False,False,198,128,medium,low,medium
354,Mega Banette,Ghost,NaN,555,64,165,75,93,83,75,3,False,False,True,258,158,high,low,medium
355,Duskull,Ghost,NaN,295,20,40,90,30,90,25,3,False,False,False,70,180,low,medium,low
356,Dusclops,Ghost,NaN,455,40,70,130,60,130,25,3,False,False,False,130,260,low,medium,low
357,Tropius,Grass,Flying,460,99,68,83,72,87,51,3,False,False,False,140,170,medium,low,low
358,Chimecho,Psychic,NaN,425,65,50,70,95,80,65,3,False,False,False,145,150,medium,low,medium
359,Absol,Dark,NaN,465,65,130,60,75,60,75,3,False,False,False,205,120,medium,low,medium
359,Mega Absol,Dark,NaN,565,65,150,60,115,60,115,3,False,False,True,265,120,high,low,medium
360,Wynaut,Psychic,NaN,260,95,23,48,23,48,23,3,False,False,False,46,96,low,low,low
361,Snorunt,Ice,NaN,300,50,50,50,50,50,50,3,False,False,False,100,100,low,low,low
362,Glalie,Ice,NaN,480,80,80,80,80,80,80,3,False,False,False,160,160,medium,low,medium
362,Mega Glalie,Ice,NaN,580,80,120,80,120,80,100,3,False,False,True,240,160,medium,low,medium
363,Spheal,Ice,Water,290,70,40,50,55,50,25,3,False,False,False,95,100,low,low,low
364,Sealeo,Ice,Water,410,90,60,70,75,70,45,3,False,False,False,135,140,medium,low,low
365,Walrein,Ice,Water,530,110,80,90,95,90,65,3,False,False,False,175,180,medium,medium,medium
366,Clamperl,Water,NaN,345,35,64,85,74,55,32,3,False,False,False,138,140,medium,low,low
367,Huntail,Water,NaN,485,55,104,105,94,75,52,3,False,False,False,198,180,medium,medium,low
368,Gorebyss,Water,NaN,485,55,84,105,114,75,52,3,False,False,False,198,180,medium,medium,low
369,Relicanth,Water,Rock,485,100,90,130,45,65,55,3,False,False,False,135,195,medium,medium,low
370,Luvdisc,Water,NaN,330,43,30,55,40,65,97,3,False,False,False,70,120,low,low,medium
371,Bagon,Dragon,NaN,300,45,75,60,40,30,50,3,False,False,False,115,90,low,low,low
372,Shelgon,Dragon,NaN,420,65,95,100,60,50,50,3,False,False,False,155,150,medium,low,low
373,Salamence,Dragon,Flying,600,95,135,80,110,80,100,3,False,False,False,245,160,medium,low,medium
373,Mega Salamence,Dragon,Flying,700,95,145,130,120,90,120,3,False,False,True,265,220,high,medium,medium
374,Beldum,Steel,Psychic,300,40,55,80,35,60,30,3,False,False,False,90,140,low,low,low
375,Metang,Steel,Psychic,420,60,75,100,55,80,50,3,False,False,False,130,180,low,medium,low
376,Metagross,Steel,Psychic,600,80,135,130,95,90,70,3,False,False,False,230,220,medium,medium,medium
376,Mega Metagross,Steel,Psychic,700,80,145,150,105,110,110,3,False,False,True,250,260,high,medium,medium
377,Regirock,Rock,NaN,580,80,100,200,50,100,50,3,True,False,False,150,300,medium,medium,low
378,Regice,Ice,NaN,580,80,50,100,100,200,50,3,True,False,False,150,300,medium,medium,low
379,Registeel,Steel,NaN,580,80,75,150,75,150,50,3,True,False,False,150,300,medium,medium,low
380,Latias,Dragon,Psychic,600,80,80,90,110,130,110,3,True,False,False,190,220,medium,medium,medium
380,Mega Latias,Dragon,Psychic,700,80,100,120,140,150,110,3,True,False,True,240,270,medium,medium,medium
381,Latios,Dragon,Psychic,600,80,90,80,130,110,110,3,True,False,False,220,190,medium,medium,medium
381,Mega Latios,Dragon,Psychic,700,80,130,100,160,120,110,3,True,False,True,290,220,high,medium,medium
382,Kyogre,Water,NaN,670,100,100,90,150,140,90,3,True,False,False,250,230,high,medium,medium
382,Primal Kyogre,Water,NaN,770,100,150,90,180,160,90,3,True,True,False,330,250,high,medium,medium
383,Groudon,Ground,NaN,670,100,150,140,100,90,90,3,True,False,False,250,230,high,medium,medium
383,Primal Groudon,Ground,Fire,770,100,180,160,150,90,90,3,True,True,False,330,250,high,medium,medium
384,Rayquaza,Dragon,Flying,680,105,150,90,150,90,95,3,True,False,False,300,180,high,medium,medium
384,Mega Rayquaza,Dragon,Flying,780,105,180,100,180,100,115,3,True,False,True,360,200,high,medium,medium
385,Jirachi,Steel,Psychic,600,100,100,100,100,100,100,3,True,False,False,200,200,medium,medium,medium
386,DeoxysNormal Forme,Psychic,NaN,600,50,150,50,150,50,150,3,True,False,False,300,100,high,low,high
386,DeoxysAttack Forme,Psychic,NaN,600,50,180,20,180,20,150,3,True,False,False,360,40,high,low,high
386,DeoxysDefense Forme,Psychic,NaN,600,50,70,160,70,160,90,3,True,False,False,140,320,medium,high,medium
386,DeoxysSpeed Forme,Psychic,NaN,600,50,95,90,95,90,180,3,True,False,False,190,180,medium,medium,high
387,Turtwig,Grass,NaN,318,55,68,64,45,55,31,4,False,False,False,113,119,low,low,low
388,Grotle,Grass,NaN,405,75,89,85,55,65,36,4,False,False,False,144,150,medium,low,low
389,Torterra,Grass,Ground,525,95,109,105,75,85,56,4,False,False,False,184,190,medium,medium,low
390,Chimchar,Fire,NaN,309,44,58,44,58,44,61,4,False,False,False,116,88,low,low,low
391,Monferno,Fire,Fighting,405,64,78,52,78,52,81,4,False,False,False,156,104,medium,low,medium
392,Infernape,Fire,Fighting,534,76,104,71,104,71,108,4,False,False,False,208,142,medium,low,medium
393,Piplup,Water,NaN,314,53,51,53,61,56,40,4,False,False,False,112,109,low,low,low
394,Prinplup,Water,NaN,405,64,66,68,81,76,50,4,False,False,False,147,144,medium,low,low
395,Empoleon,Water,Steel,530,84,86,88,111,101,60,4,False,False,False,197,189,medium,medium,low
396,Starly,Normal,Flying,245,40,55,30,30,30,60,4,False,False,False,85,60,low,low,low
397,Staravia,Normal,Flying,340,55,75,50,40,40,80,4,False,False,False,115,90,low,low,medium
398,Staraptor,Normal,Flying,485,85,120,70,50,60,100,4,False,False,False,170,130,medium,low,medium
399,Bidoof,Normal,NaN,250,59,45,40,35,40,31,4,False,False,False,80,80,low,low,low
400,Bibarel,Normal,Water,410,79,85,60,55,60,71,4,False,False,False,140,120,medium,low,medium
401,Kricketot,Bug,NaN,194,37,25,41,25,41,25,4,False,False,False,50,82,low,low,low
402,Kricketune,Bug,NaN,384,77,85,51,55,51,65,4,False,False,False,140,102,medium,low,medium
403,Shinx,Electric,NaN,263,45,65,34,40,34,45,4,False,False,False,105,68,low,low,low
404,Luxio,Electric,NaN,363,60,85,49,60,49,60,4,False,False,False,145,98,medium,low,low
405,Luxray,Electric,NaN,523,80,120,79,95,79,70,4,False,False,False,215,158,medium,low,medium
406,Budew,Grass,Poison,280,40,30,35,50,70,55,4,False,False,False,80,105,low,low,low
407,Roserade,Grass,Poison,515,60,70,65,125,105,90,4,False,False,False,195,170,medium,low,medium
408,Cranidos,Rock,NaN,350,67,125,40,30,30,58,4,False,False,False,155,70,medium,low,low
409,Rampardos,Rock,NaN,495,97,165,60,65,50,58,4,False,False,False,230,110,medium,low,low
410,Shieldon,Rock,Steel,350,30,42,118,42,88,30,4,False,False,False,84,206,low,medium,low
411,Bastiodon,Rock,Steel,495,60,52,168,47,138,30,4,False,False,False,99,306,low,medium,low
412,Burmy,Bug,NaN,224,40,29,45,29,45,36,4,False,False,False,58,90,low,low,low
413,WormadamPlant Cloak,Bug,Grass,424,60,59,85,79,105,36,4,False,False,False,138,190,medium,medium,low
413,WormadamSandy Cloak,Bug,Ground,424,60,79,105,59,85,36,4,False,False,False,138,190,medium,medium,low
413,WormadamTrash Cloak,Bug,Steel,424,60,69,95,69,95,36,4,False,False,False,138,190,medium,medium,low
414,Mothim,Bug,Flying,424,70,94,50,94,50,66,4,False,False,False,188,100,medium,low,medium
415,Combee,Bug,Flying,244,30,30,42,30,42,70,4,False,False,False,60,84,low,low,medium
416,Vespiquen,Bug,Flying,474,70,80,102,80,102,40,4,False,False,False,160,204,medium,medium,low
417,Pachirisu,Electric,NaN,405,60,45,70,45,90,95,4,False,False,False,90,160,low,low,medium
418,Buizel,Water,NaN,330,55,65,35,60,30,85,4,False,False,False,125,65,low,low,medium
419,Floatzel,Water,NaN,495,85,105,55,85,50,115,4,False,False,False,190,105,medium,low,medium
420,Cherubi,Grass,NaN,275,45,35,45,62,53,35,4,False,False,False,97,98,low,low,low
421,Cherrim,Grass,NaN,450,70,60,70,87,78,85,4,False,False,False,147,148,medium,low,medium
422,Shellos,Water,NaN,325,76,48,48,57,62,34,4,False,False,False,105,110,low,low,low
423,Gastrodon,Water,Ground,475,111,83,68,92,82,39,4,False,False,False,175,150,medium,low,low
424,Ambipom,Normal,NaN,482,75,100,66,60,66,115,4,False,False,False,160,132,medium,low,medium
425,Drifloon,Ghost,Flying,348,90,50,34,60,44,70,4,False,False,False,110,78,low,low,medium
426,Drifblim,Ghost,Flying,498,150,80,44,90,54,80,4,False,False,False,170,98,medium,low,medium
427,Buneary,Normal,NaN,350,55,66,44,44,56,85,4,False,False,False,110,100,low,low,medium
428,Lopunny,Normal,NaN,480,65,76,84,54,96,105,4,False,False,False,130,180,low,medium,medium
428,Mega Lopunny,Normal,Fighting,580,65,136,94,54,96,135,4,False,False,True,190,190,medium,medium,high
429,Mismagius,Ghost,NaN,495,60,60,60,105,105,105,4,False,False,False,165,165,medium,low,medium
430,Honchkrow,Dark,Flying,505,100,125,52,105,52,71,4,False,False,False,230,104,medium,low,medium
431,Glameow,Normal,NaN,310,49,55,42,42,37,85,4,False,False,False,97,79,low,low,medium
432,Purugly,Normal,NaN,452,71,82,64,64,59,112,4,False,False,False,146,123,medium,low,medium
433,Chingling,Psychic,NaN,285,45,30,50,65,50,45,4,False,False,False,95,100,low,low,low
434,Stunky,Poison,Dark,329,63,63,47,41,41,74,4,False,False,False,104,88,low,low,medium
435,Skuntank,Poison,Dark,479,103,93,67,71,61,84,4,False,False,False,164,128,medium,low,medium
436,Bronzor,Steel,Psychic,300,57,24,86,24,86,23,4,False,False,False,48,172,low,low,low
437,Bronzong,Steel,Psychic,500,67,89,116,79,116,33,4,False,False,False,168,232,medium,medium,low
438,Bonsly,Rock,NaN,290,50,80,95,10,45,10,4,False,False,False,90,140,low,low,low
439,Mime Jr.,Psychic,Fairy,310,20,25,45,70,90,60,4,False,False,False,95,135,low,low,low
440,Happiny,Normal,NaN,220,100,5,5,15,65,30,4,False,False,False,20,70,low,low,low
441,Chatot,Normal,Flying,411,76,65,45,92,42,91,4,False,False,False,157,87,medium,low,medium
442,Spiritomb,Ghost,Dark,485,50,92,108,92,108,35,4,False,False,False,184,216,medium,medium,low
443,Gible,Dragon,Ground,300,58,70,45,40,45,42,4,False,False,False,110,90,low,low,low
444,Gabite,Dragon,Ground,410,68,90,65,50,55,82,4,False,False,False,140,120,medium,low,medium
445,Garchomp,Dragon,Ground,600,108,130,95,80,85,102,4,False,False,False,210,180,medium,medium,medium
445,Mega Garchomp,Dragon,Ground,700,108,170,115,120,95,92,4,False,False,True,290,210,high,medium,medium
446,Munchlax,Normal,NaN,390,135,85,40,40,85,5,4,False,False,False,125,125,low,low,low
447,Riolu,Fighting,NaN,285,40,70,40,35,40,60,4,False,False,False,105,80,low,low,low
448,Lucario,Fighting,Steel,525,70,110,70,115,70,90,4,False,False,False,225,140,medium,low,medium
448,Mega Lucario,Fighting,Steel,625,70,145,88,140,70,112,4,False,False,True,285,158,high,low,medium
449,Hippopotas,Ground,NaN,330,68,72,78,38,42,32,4,False,False,False,110,120,low,low,low
450,Hippowdon,Ground,NaN,525,108,112,118,68,72,47,4,False,False,False,180,190,medium,medium,low
451,Skorupi,Poison,Bug,330,40,50,90,30,55,65,4,False,False,False,80,145,low,low,medium
452,Drapion,Poison,Dark,500,70,90,110,60,75,95,4,False,False,False,150,185,medium,medium,medium
453,Croagunk,Poison,Fighting,300,48,61,40,61,40,50,4,False,False,False,122,80,low,low,low
454,Toxicroak,Poison,Fighting,490,83,106,65,86,65,85,4,False,False,False,192,130,medium,low,medium
455,Carnivine,Grass,NaN,454,74,100,72,90,72,46,4,False,False,False,190,144,medium,low,low
456,Finneon,Water,NaN,330,49,49,56,49,61,66,4,False,False,False,98,117,low,low,medium
457,Lumineon,Water,NaN,460,69,69,76,69,86,91,4,False,False,False,138,162,medium,low,medium
458,Mantyke,Water,Flying,345,45,20,50,60,120,50,4,False,False,False,80,170,low,low,low
459,Snover,Grass,Ice,334,60,62,50,62,60,40,4,False,False,False,124,110,low,low,low
460,Abomasnow,Grass,Ice,494,90,92,75,92,85,60,4,False,False,False,184,160,medium,low,low
460,Mega Abomasnow,Grass,Ice,594,90,132,105,132,105,30,4,False,False,True,264,210,high,medium,low
461,Weavile,Dark,Ice,510,70,120,65,45,85,125,4,False,False,False,165,150,medium,low,high
462,Magnezone,Electric,Steel,535,70,70,115,130,90,60,4,False,False,False,200,205,medium,medium,low
463,Lickilicky,Normal,NaN,515,110,85,95,80,95,50,4,False,False,False,165,190,medium,medium,low
464,Rhyperior,Ground,Rock,535,115,140,130,55,55,40,4,False,False,False,195,185,medium,medium,low
465,Tangrowth,Grass,NaN,535,100,100,125,110,50,50,4,False,False,False,210,175,medium,low,low
466,Electivire,Electric,NaN,540,75,123,67,95,85,95,4,False,False,False,218,152,medium,low,medium
467,Magmortar,Fire,NaN,540,75,95,67,125,95,83,4,False,False,False,220,162,medium,low,medium
468,Togekiss,Fairy,Flying,545,85,50,95,120,115,80,4,False,False,False,170,210,medium,medium,medium
469,Yanmega,Bug,Flying,515,86,76,86,116,56,95,4,False,False,False,192,142,medium,low,medium
470,Leafeon,Grass,NaN,525,65,110,130,60,65,95,4,False,False,False,170,195,medium,medium,medium
471,Glaceon,Ice,NaN,525,65,60,110,130,95,65,4,False,False,False,190,205,medium,medium,medium
472,Gliscor,Ground,Flying,510,75,95,125,45,75,95,4,False,False,False,140,200,medium,medium,medium
473,Mamoswine,Ice,Ground,530,110,130,80,70,60,80,4,False,False,False,200,140,medium,low,medium
474,Porygon-Z,Normal,NaN,535,85,80,70,135,75,90,4,False,False,False,215,145,medium,low,medium
475,Gallade,Psychic,Fighting,518,68,125,65,65,115,80,4,False,False,False,190,180,medium,medium,medium
475,Mega Gallade,Psychic,Fighting,618,68,165,95,65,115,110,4,False,False,True,230,210,medium,medium,medium
476,Probopass,Rock,Steel,525,60,55,145,75,150,40,4,False,False,False,130,295,low,medium,low
477,Dusknoir,Ghost,NaN,525,45,100,135,65,135,45,4,False,False,False,165,270,medium,medium,low
478,Froslass,Ice,Ghost,480,70,80,70,80,70,110,4,False,False,False,160,140,medium,low,medium
479,Rotom,Electric,Ghost,440,50,50,77,95,77,91,4,False,False,False,145,154,medium,low,medium
479,RotomHeat Rotom,Electric,Fire,520,50,65,107,105,107,86,4,False,False,False,170,214,medium,medium,medium
479,RotomWash Rotom,Electric,Water,520,50,65,107,105,107,86,4,False,False,False,170,214,medium,medium,medium
479,RotomFrost Rotom,Electric,Ice,520,50,65,107,105,107,86,4,False,False,False,170,214,medium,medium,medium
479,RotomFan Rotom,Electric,Flying,520,50,65,107,105,107,86,4,False,False,False,170,214,medium,medium,medium
479,RotomMow Rotom,Electric,Grass,520,50,65,107,105,107,86,4,False,False,False,170,214,medium,medium,medium
480,Uxie,Psychic,NaN,580,75,75,130,75,130,95,4,True,False,False,150,260,medium,medium,medium
481,Mesprit,Psychic,NaN,580,80,105,105,105,105,80,4,True,False,False,210,210,medium,medium,medium
482,Azelf,Psychic,NaN,580,75,125,70,125,70,115,4,True,False,False,250,140,high,low,medium
483,Dialga,Steel,Dragon,680,100,120,120,150,100,90,4,True,False,False,270,220,high,medium,medium
484,Palkia,Water,Dragon,680,90,120,100,150,120,100,4,True,False,False,270,220,high,medium,medium
485,Heatran,Fire,Steel,600,91,90,106,130,106,77,4,True,False,False,220,212,medium,medium,medium
486,Regigigas,Normal,NaN,670,110,160,110,80,110,100,4,True,False,False,240,220,medium,medium,medium
487,GiratinaAltered Forme,Ghost,Dragon,680,150,100,120,100,120,90,4,True,False,False,200,240,medium,medium,medium
487,GiratinaOrigin Forme,Ghost,Dragon,680,150,120,100,120,100,90,4,True,False,False,240,200,medium,medium,medium
488,Cresselia,Psychic,NaN,600,120,70,120,75,130,85,4,False,False,False,145,250,medium,medium,medium
489,Phione,Water,NaN,480,80,80,80,80,80,80,4,False,False,False,160,160,medium,low,medium
490,Manaphy,Water,NaN,600,100,100,100,100,100,100,4,False,False,False,200,200,medium,medium,medium
491,Darkrai,Dark,NaN,600,70,90,90,135,90,125,4,True,False,False,225,180,medium,medium,high
492,ShayminLand Forme,Grass,NaN,600,100,100,100,100,100,100,4,True,False,False,200,200,medium,medium,medium
492,ShayminSky Forme,Grass,Flying,600,100,103,75,120,75,127,4,True,False,False,223,150,medium,low,high
493,Arceus,Normal,NaN,720,120,120,120,120,120,120,4,True,False,False,240,240,medium,medium,medium
494,Victini,Psychic,Fire,600,100,100,100,100,100,100,5,True,False,False,200,200,medium,medium,medium
495,Snivy,Grass,NaN,308,45,45,55,45,55,63,5,False,False,False,90,110,low,low,low
496,Servine,Grass,NaN,413,60,60,75,60,75,83,5,False,False,False,120,150,low,low,medium
497,Serperior,Grass,NaN,528,75,75,95,75,95,113,5,False,False,False,150,190,medium,medium,medium
498,Tepig,Fire,NaN,308,65,63,45,45,45,45,5,False,False,False,108,90,low,low,low
499,Pignite,Fire,Fighting,418,90,93,55,70,55,55,5,False,False,False,163,110,medium,low,low
500,Emboar,Fire,Fighting,528,110,123,65,100,65,65,5,False,False,False,223,130,medium,low,medium
501,Oshawott,Water,NaN,308,55,55,45,63,45,45,5,False,False,False,118,90,low,low,low
502,Dewott,Water,NaN,413,75,75,60,83,60,60,5,False,False,False,158,120,medium,low,low
503,Samurott,Water,NaN,528,95,100,85,108,70,70,5,False,False,False,208,155,medium,low,medium
504,Patrat,Normal,NaN,255,45,55,39,35,39,42,5,False,False,False,90,78,low,low,low
505,Watchog,Normal,NaN,420,60,85,69,60,69,77,5,False,False,False,145,138,medium,low,medium
506,Lillipup,Normal,NaN,275,45,60,45,25,45,55,5,False,False,False,85,90,low,low,low
507,Herdier,Normal,NaN,370,65,80,65,35,65,60,5,False,False,False,115,130,low,low,low
508,Stoutland,Normal,NaN,500,85,110,90,45,90,80,5,False,False,False,155,180,medium,medium,medium
509,Purrloin,Dark,NaN,281,41,50,37,50,37,66,5,False,False,False,100,74,low,low,medium
510,Liepard,Dark,NaN,446,64,88,50,88,50,106,5,False,False,False,176,100,medium,low,medium
511,Pansage,Grass,NaN,316,50,53,48,53,48,64,5,False,False,False,106,96,low,low,medium
512,Simisage,Grass,NaN,498,75,98,63,98,63,101,5,False,False,False,196,126,medium,low,medium
513,Pansear,Fire,NaN,316,50,53,48,53,48,64,5,False,False,False,106,96,low,low,medium
514,Simisear,Fire,NaN,498,75,98,63,98,63,101,5,False,False,False,196,126,medium,low,medium
515,Panpour,Water,NaN,316,50,53,48,53,48,64,5,False,False,False,106,96,low,low,medium
516,Simipour,Water,NaN,498,75,98,63,98,63,101,5,False,False,False,196,126,medium,low,medium
517,Munna,Psychic,NaN,292,76,25,45,67,55,24,5,False,False,False,92,100,low,low,low
518,Musharna,Psychic,NaN,487,116,55,85,107,95,29,5,False,False,False,162,180,medium,medium,low
519,Pidove,Normal,Flying,264,50,55,50,36,30,43,5,False,False,False,91,80,low,low,low
520,Tranquill,Normal,Flying,358,62,77,62,50,42,65,5,False,False,False,127,104,low,low,medium
521,Unfezant,Normal,Flying,488,80,115,80,65,55,93,5,False,False,False,180,135,medium,low,medium
522,Blitzle,Electric,NaN,295,45,60,32,50,32,76,5,False,False,False,110,64,low,low,medium
523,Zebstrika,Electric,NaN,497,75,100,63,80,63,116,5,False,False,False,180,126,medium,low,medium
524,Roggenrola,Rock,NaN,280,55,75,85,25,25,15,5,False,False,False,100,110,low,low,low
525,Boldore,Rock,NaN,390,70,105,105,50,40,20,5,False,False,False,155,145,medium,low,low
526,Gigalith,Rock,NaN,515,85,135,130,60,80,25,5,False,False,False,195,210,medium,medium,low
527,Woobat,Psychic,Flying,313,55,45,43,55,43,72,5,False,False,False,100,86,low,low,medium
528,Swoobat,Psychic,Flying,425,67,57,55,77,55,114,5,False,False,False,134,110,medium,low,medium
529,Drilbur,Ground,NaN,328,60,85,40,30,45,68,5,False,False,False,115,85,low,low,medium
530,Excadrill,Ground,Steel,508,110,135,60,50,65,88,5,False,False,False,185,125,medium,low,medium
531,Audino,Normal,NaN,445,103,60,86,60,86,50,5,False,False,False,120,172,low,low,low
531,Mega Audino,Normal,Fairy,545,103,60,126,80,126,50,5,False,False,True,140,252,medium,medium,low
532,Timburr,Fighting,NaN,305,75,80,55,25,35,35,5,False,False,False,105,90,low,low,low
533,Gurdurr,Fighting,NaN,405,85,105,85,40,50,40,5,False,False,False,145,135,medium,low,low
534,Conkeldurr,Fighting,NaN,505,105,140,95,55,65,45,5,False,False,False,195,160,medium,low,low
535,Tympole,Water,NaN,294,50,50,40,50,40,64,5,False,False,False,100,80,low,low,medium
536,Palpitoad,Water,Ground,384,75,65,55,65,55,69,5,False,False,False,130,110,low,low,medium
537,Seismitoad,Water,Ground,509,105,95,75,85,75,74,5,False,False,False,180,150,medium,low,medium
538,Throh,Fighting,NaN,465,120,100,85,30,85,45,5,False,False,False,130,170,low,low,low
539,Sawk,Fighting,NaN,465,75,125,75,30,75,85,5,False,False,False,155,150,medium,low,medium
540,Sewaddle,Bug,Grass,310,45,53,70,40,60,42,5,False,False,False,93,130,low,low,low
541,Swadloon,Bug,Grass,380,55,63,90,50,80,42,5,False,False,False,113,170,low,low,low
542,Leavanny,Bug,Grass,500,75,103,80,70,80,92,5,False,False,False,173,160,medium,low,medium
543,Venipede,Bug,Poison,260,30,45,59,30,39,57,5,False,False,False,75,98,low,low,low
544,Whirlipede,Bug,Poison,360,40,55,99,40,79,47,5,False,False,False,95,178,low,medium,low
545,Scolipede,Bug,Poison,485,60,100,89,55,69,112,5,False,False,False,155,158,medium,low,medium
546,Cottonee,Grass,Fairy,280,40,27,60,37,50,66,5,False,False,False,64,110,low,low,medium
547,Whimsicott,Grass,Fairy,480,60,67,85,77,75,116,5,False,False,False,144,160,medium,low,medium
548,Petilil,Grass,NaN,280,45,35,50,70,50,30,5,False,False,False,105,100,low,low,low
549,Lilligant,Grass,NaN,480,70,60,75,110,75,90,5,False,False,False,170,150,medium,low,medium
550,Basculin,Water,NaN,460,70,92,65,80,55,98,5,False,False,False,172,120,medium,low,medium
551,Sandile,Ground,Dark,292,50,72,35,35,35,65,5,False,False,False,107,70,low,low,medium
552,Krokorok,Ground,Dark,351,60,82,45,45,45,74,5,False,False,False,127,90,low,low,medium
553,Krookodile,Ground,Dark,519,95,117,80,65,70,92,5,False,False,False,182,150,medium,low,medium
554,Darumaka,Fire,NaN,315,70,90,45,15,45,50,5,False,False,False,105,90,low,low,low
555,DarmanitanStandard Mode,Fire,NaN,480,105,140,55,30,55,95,5,False,False,False,170,110,medium,low,medium
555,DarmanitanZen Mode,Fire,Psychic,540,105,30,105,140,105,55,5,False,False,False,170,210,medium,medium,low
556,Maractus,Grass,NaN,461,75,86,67,106,67,60,5,False,False,False,192,134,medium,low,low
557,Dwebble,Bug,Rock,325,50,65,85,35,35,55,5,False,False,False,100,120,low,low,low
558,Crustle,Bug,Rock,475,70,95,125,65,75,45,5,False,False,False,160,200,medium,medium,low
559,Scraggy,Dark,Fighting,348,50,75,70,35,70,48,5,False,False,False,110,140,low,low,low
560,Scrafty,Dark,Fighting,488,65,90,115,45,115,58,5,False,False,False,135,230,medium,medium,low
561,Sigilyph,Psychic,Flying,490,72,58,80,103,80,97,5,False,False,False,161,160,medium,low,medium
562,Yamask,Ghost,NaN,303,38,30,85,55,65,30,5,False,False,False,85,150,low,low,low
563,Cofagrigus,Ghost,NaN,483,58,50,145,95,105,30,5,False,False,False,145,250,medium,medium,low
564,Tirtouga,Water,Rock,355,54,78,103,53,45,22,5,False,False,False,131,148,low,low,low
565,Carracosta,Water,Rock,495,74,108,133,83,65,32,5,False,False,False,191,198,medium,medium,low
566,Archen,Rock,Flying,401,55,112,45,74,45,70,5,False,False,False,186,90,medium,low,medium
567,Archeops,Rock,Flying,567,75,140,65,112,65,110,5,False,False,False,252,130,high,low,medium
568,Trubbish,Poison,NaN,329,50,50,62,40,62,65,5,False,False,False,90,124,low,low,medium
569,Garbodor,Poison,NaN,474,80,95,82,60,82,75,5,False,False,False,155,164,medium,low,medium
570,Zorua,Dark,NaN,330,40,65,40,80,40,65,5,False,False,False,145,80,medium,low,medium
571,Zoroark,Dark,NaN,510,60,105,60,120,60,105,5,False,False,False,225,120,medium,low,medium
572,Minccino,Normal,NaN,300,55,50,40,40,40,75,5,False,False,False,90,80,low,low,medium
573,Cinccino,Normal,NaN,470,75,95,60,65,60,115,5,False,False,False,160,120,medium,low,medium
574,Gothita,Psychic,NaN,290,45,30,50,55,65,45,5,False,False,False,85,115,low,low,low
575,Gothorita,Psychic,NaN,390,60,45,70,75,85,55,5,False,False,False,120,155,low,low,low
576,Gothitelle,Psychic,NaN,490,70,55,95,95,110,65,5,False,False,False,150,205,medium,medium,medium
577,Solosis,Psychic,NaN,290,45,30,40,105,50,20,5,False,False,False,135,90,medium,low,low
578,Duosion,Psychic,NaN,370,65,40,50,125,60,30,5,False,False,False,165,110,medium,low,low
579,Reuniclus,Psychic,NaN,490,110,65,75,125,85,30,5,False,False,False,190,160,medium,low,low
580,Ducklett,Water,Flying,305,62,44,50,44,50,55,5,False,False,False,88,100,low,low,low
581,Swanna,Water,Flying,473,75,87,63,87,63,98,5,False,False,False,174,126,medium,low,medium
582,Vanillite,Ice,NaN,305,36,50,50,65,60,44,5,False,False,False,115,110,low,low,low
583,Vanillish,Ice,NaN,395,51,65,65,80,75,59,5,False,False,False,145,140,medium,low,low
584,Vanilluxe,Ice,NaN,535,71,95,85,110,95,79,5,False,False,False,205,180,medium,medium,medium
585,Deerling,Normal,Grass,335,60,60,50,40,50,75,5,False,False,False,100,100,low,low,medium
586,Sawsbuck,Normal,Grass,475,80,100,70,60,70,95,5,False,False,False,160,140,medium,low,medium
587,Emolga,Electric,Flying,428,55,75,60,75,60,103,5,False,False,False,150,120,medium,low,medium
588,Karrablast,Bug,NaN,315,50,75,45,40,45,60,5,False,False,False,115,90,low,low,low
589,Escavalier,Bug,Steel,495,70,135,105,60,105,20,5,False,False,False,195,210,medium,medium,low
590,Foongus,Grass,Poison,294,69,55,45,55,55,15,5,False,False,False,110,100,low,low,low
591,Amoonguss,Grass,Poison,464,114,85,70,85,80,30,5,False,False,False,170,150,medium,low,low
592,Frillish,Water,Ghost,335,55,40,50,65,85,40,5,False,False,False,105,135,low,low,low
593,Jellicent,Water,Ghost,480,100,60,70,85,105,60,5,False,False,False,145,175,medium,low,low
594,Alomomola,Water,NaN,470,165,75,80,40,45,65,5,False,False,False,115,125,low,low,medium
595,Joltik,Bug,Electric,319,50,47,50,57,50,65,5,False,False,False,104,100,low,low,medium
596,Galvantula,Bug,Electric,472,70,77,60,97,60,108,5,False,False,False,174,120,medium,low,medium
597,Ferroseed,Grass,Steel,305,44,50,91,24,86,10,5,False,False,False,74,177,low,medium,low
598,Ferrothorn,Grass,Steel,489,74,94,131,54,116,20,5,False,False,False,148,247,medium,medium,low
599,Klink,Steel,NaN,300,40,55,70,45,60,30,5,False,False,False,100,130,low,low,low
600,Klang,Steel,NaN,440,60,80,95,70,85,50,5,False,False,False,150,180,medium,medium,low
601,Klinklang,Steel,NaN,520,60,100,115,70,85,90,5,False,False,False,170,200,medium,medium,medium
602,Tynamo,Electric,NaN,275,35,55,40,45,40,60,5,False,False,False,100,80,low,low,low
603,Eelektrik,Electric,NaN,405,65,85,70,75,70,40,5,False,False,False,160,140,medium,low,low
604,Eelektross,Electric,NaN,515,85,115,80,105,80,50,5,False,False,False,220,160,medium,low,low
605,Elgyem,Psychic,NaN,335,55,55,55,85,55,30,5,False,False,False,140,110,medium,low,low
606,Beheeyem,Psychic,NaN,485,75,75,75,125,95,40,5,False,False,False,200,170,medium,low,low
607,Litwick,Ghost,Fire,275,50,30,55,65,55,20,5,False,False,False,95,110,low,low,low
608,Lampent,Ghost,Fire,370,60,40,60,95,60,55,5,False,False,False,135,120,medium,low,low
609,Chandelure,Ghost,Fire,520,60,55,90,145,90,80,5,False,False,False,200,180,medium,medium,medium
610,Axew,Dragon,NaN,320,46,87,60,30,40,57,5,False,False,False,117,100,low,low,low
611,Fraxure,Dragon,NaN,410,66,117,70,40,50,67,5,False,False,False,157,120,medium,low,medium
612,Haxorus,Dragon,NaN,540,76,147,90,60,70,97,5,False,False,False,207,160,medium,low,medium
613,Cubchoo,Ice,NaN,305,55,70,40,60,40,40,5,False,False,False,130,80,low,low,low
614,Beartic,Ice,NaN,485,95,110,80,70,80,50,5,False,False,False,180,160,medium,low,low
615,Cryogonal,Ice,NaN,485,70,50,30,95,135,105,5,False,False,False,145,165,medium,low,medium
616,Shelmet,Bug,NaN,305,50,40,85,40,65,25,5,False,False,False,80,150,low,low,low
617,Accelgor,Bug,NaN,495,80,70,40,100,60,145,5,False,False,False,170,100,medium,low,high
618,Stunfisk,Ground,Electric,471,109,66,84,81,99,32,5,False,False,False,147,183,medium,medium,low
619,Mienfoo,Fighting,NaN,350,45,85,50,55,50,65,5,False,False,False,140,100,medium,low,medium
620,Mienshao,Fighting,NaN,510,65,125,60,95,60,105,5,False,False,False,220,120,medium,low,medium
621,Druddigon,Dragon,NaN,485,77,120,90,60,90,48,5,False,False,False,180,180,medium,medium,low
622,Golett,Ground,Ghost,303,59,74,50,35,50,35,5,False,False,False,109,100,low,low,low
623,Golurk,Ground,Ghost,483,89,124,80,55,80,55,5,False,False,False,179,160,medium,low,low
624,Pawniard,Dark,Steel,340,45,85,70,40,40,60,5,False,False,False,125,110,low,low,low
625,Bisharp,Dark,Steel,490,65,125,100,60,70,70,5,False,False,False,185,170,medium,low,medium
626,Bouffalant,Normal,NaN,490,95,110,95,40,95,55,5,False,False,False,150,190,medium,medium,low
627,Rufflet,Normal,Flying,350,70,83,50,37,50,60,5,False,False,False,120,100,low,low,low
628,Braviary,Normal,Flying,510,100,123,75,57,75,80,5,False,False,False,180,150,medium,low,medium
629,Vullaby,Dark,Flying,370,70,55,75,45,65,60,5,False,False,False,100,140,low,low,low
630,Mandibuzz,Dark,Flying,510,110,65,105,55,95,80,5,False,False,False,120,200,low,medium,medium
631,Heatmor,Fire,NaN,484,85,97,66,105,66,65,5,False,False,False,202,132,medium,low,medium
632,Durant,Bug,Steel,484,58,109,112,48,48,109,5,False,False,False,157,160,medium,low,medium
633,Deino,Dark,Dragon,300,52,65,50,45,50,38,5,False,False,False,110,100,low,low,low
634,Zweilous,Dark,Dragon,420,72,85,70,65,70,58,5,False,False,False,150,140,medium,low,low
635,Hydreigon,Dark,Dragon,600,92,105,90,125,90,98,5,False,False,False,230,180,medium,medium,medium
636,Larvesta,Bug,Fire,360,55,85,55,50,55,60,5,False,False,False,135,110,medium,low,low
637,Volcarona,Bug,Fire,550,85,60,65,135,105,100,5,False,False,False,195,170,medium,low,medium
638,Cobalion,Steel,Fighting,580,91,90,129,90,72,108,5,True,False,False,180,201,medium,medium,medium
639,Terrakion,Rock,Fighting,580,91,129,90,72,90,108,5,True,False,False,201,180,medium,medium,medium
640,Virizion,Grass,Fighting,580,91,90,72,90,129,108,5,True,False,False,180,201,medium,medium,medium
641,TornadusIncarnate Forme,Flying,NaN,580,79,115,70,125,80,111,5,True,False,False,240,150,medium,low,medium
641,TornadusTherian Forme,Flying,NaN,580,79,100,80,110,90,121,5,True,False,False,210,170,medium,low,medium
642,ThundurusIncarnate Forme,Electric,Flying,580,79,115,70,125,80,111,5,True,False,False,240,150,medium,low,medium
642,ThundurusTherian Forme,Electric,Flying,580,79,105,70,145,80,101,5,True,False,False,250,150,high,low,medium
643,Reshiram,Dragon,Fire,680,100,120,100,150,120,90,5,True,False,False,270,220,high,medium,medium
644,Zekrom,Dragon,Electric,680,100,150,120,120,100,90,5,True,False,False,270,220,high,medium,medium
645,LandorusIncarnate Forme,Ground,Flying,600,89,125,90,115,80,101,5,True,False,False,240,170,medium,low,medium
645,LandorusTherian Forme,Ground,Flying,600,89,145,90,105,80,91,5,True,False,False,250,170,high,low,medium
646,Kyurem,Dragon,Ice,660,125,130,90,130,90,95,5,True,False,False,260,180,high,medium,medium
646,KyuremBlack Kyurem,Dragon,Ice,700,125,170,100,120,90,95,5,True,False,False,290,190,high,medium,medium
646,KyuremWhite Kyurem,Dragon,Ice,700,125,120,90,170,100,95,5,True,False,False,290,190,high,medium,medium
647,KeldeoOrdinary Forme,Water,Fighting,580,91,72,90,129,90,108,5,False,False,False,201,180,medium,medium,medium
647,KeldeoResolute Forme,Water,Fighting,580,91,72,90,129,90,108,5,False,False,False,201,180,medium,medium,medium
648,MeloettaAria Forme,Normal,Psychic,600,100,77,77,128,128,90,5,False,False,False,205,205,medium,medium,medium
648,MeloettaPirouette Forme,Normal,Fighting,600,100,128,90,77,77,128,5,False,False,False,205,167,medium,low,high
649,Genesect,Bug,Steel,600,71,120,95,120,95,99,5,False,False,False,240,190,medium,medium,medium
650,Chespin,Grass,NaN,313,56,61,65,48,45,38,6,False,False,False,109,110,low,low,low
651,Quilladin,Grass,NaN,405,61,78,95,56,58,57,6,False,False,False,134,153,medium,low,low
652,Chesnaught,Grass,Fighting,530,88,107,122,74,75,64,6,False,False,False,181,197,medium,medium,medium
653,Fennekin,Fire,NaN,307,40,45,40,62,60,60,6,False,False,False,107,100,low,low,low
654,Braixen,Fire,NaN,409,59,59,58,90,70,73,6,False,False,False,149,128,medium,low,medium
655,Delphox,Fire,Psychic,534,75,69,72,114,100,104,6,False,False,False,183,172,medium,low,medium
656,Froakie,Water,NaN,314,41,56,40,62,44,71,6,False,False,False,118,84,low,low,medium
657,Frogadier,Water,NaN,405,54,63,52,83,56,97,6,False,False,False,146,108,medium,low,medium
658,Greninja,Water,Dark,530,72,95,67,103,71,122,6,False,False,False,198,138,medium,low,high
659,Bunnelby,Normal,NaN,237,38,36,38,32,36,57,6,False,False,False,68,74,low,low,low
660,Diggersby,Normal,Ground,423,85,56,77,50,77,78,6,False,False,False,106,154,low,low,medium
661,Fletchling,Normal,Flying,278,45,50,43,40,38,62,6,False,False,False,90,81,low,low,low
662,Fletchinder,Fire,Flying,382,62,73,55,56,52,84,6,False,False,False,129,107,low,low,medium
663,Talonflame,Fire,Flying,499,78,81,71,74,69,126,6,False,False,False,155,140,medium,low,high
664,Scatterbug,Bug,NaN,200,38,35,40,27,25,35,6,False,False,False,62,65,low,low,low
665,Spewpa,Bug,NaN,213,45,22,60,27,30,29,6,False,False,False,49,90,low,low,low
666,Vivillon,Bug,Flying,411,80,52,50,90,50,89,6,False,False,False,142,100,medium,low,medium
667,Litleo,Fire,Normal,369,62,50,58,73,54,72,6,False,False,False,123,112,low,low,medium
668,Pyroar,Fire,Normal,507,86,68,72,109,66,106,6,False,False,False,177,138,medium,low,medium
669,Flabébé,Fairy,NaN,303,44,38,39,61,79,42,6,False,False,False,99,118,low,low,low
670,Floette,Fairy,NaN,371,54,45,47,75,98,52,6,False,False,False,120,145,low,low,low
671,Florges,Fairy,NaN,552,78,65,68,112,154,75,6,False,False,False,177,222,medium,medium,medium
672,Skiddo,Grass,NaN,350,66,65,48,62,57,52,6,False,False,False,127,105,low,low,low
673,Gogoat,Grass,NaN,531,123,100,62,97,81,68,6,False,False,False,197,143,medium,low,medium
674,Pancham,Fighting,NaN,348,67,82,62,46,48,43,6,False,False,False,128,110,low,low,low
675,Pangoro,Fighting,Dark,495,95,124,78,69,71,58,6,False,False,False,193,149,medium,low,low
676,Furfrou,Normal,NaN,472,75,80,60,65,90,102,6,False,False,False,145,150,medium,low,medium
677,Espurr,Psychic,NaN,355,62,48,54,63,60,68,6,False,False,False,111,114,low,low,medium
678,MeowsticMale,Psychic,NaN,466,74,48,76,83,81,104,6,False,False,False,131,157,low,low,medium
678,MeowsticFemale,Psychic,NaN,466,74,48,76,83,81,104,6,False,False,False,131,157,low,low,medium
679,Honedge,Steel,Ghost,325,45,80,100,35,37,28,6,False,False,False,115,137,low,low,low
680,Doublade,Steel,Ghost,448,59,110,150,45,49,35,6,False,False,False,155,199,medium,medium,low
681,AegislashBlade Forme,Steel,Ghost,520,60,150,50,150,50,60,6,False,False,False,300,100,high,low,low
681,AegislashShield Forme,Steel,Ghost,520,60,50,150,50,150,60,6,False,False,False,100,300,low,medium,low
682,Spritzee,Fairy,NaN,341,78,52,60,63,65,23,6,False,False,False,115,125,low,low,low
683,Aromatisse,Fairy,NaN,462,101,72,72,99,89,29,6,False,False,False,171,161,medium,low,low
684,Swirlix,Fairy,NaN,341,62,48,66,59,57,49,6,False,False,False,107,123,low,low,low
685,Slurpuff,Fairy,NaN,480,82,80,86,85,75,72,6,False,False,False,165,161,medium,low,medium
686,Inkay,Dark,Psychic,288,53,54,53,37,46,45,6,False,False,False,91,99,low,low,low
687,Malamar,Dark,Psychic,482,86,92,88,68,75,73,6,False,False,False,160,163,medium,low,medium
688,Binacle,Rock,Water,306,42,52,67,39,56,50,6,False,False,False,91,123,low,low,low
689,Barbaracle,Rock,Water,500,72,105,115,54,86,68,6,False,False,False,159,201,medium,medium,medium
690,Skrelp,Poison,Water,320,50,60,60,60,60,30,6,False,False,False,120,120,low,low,low
691,Dragalge,Poison,Dragon,494,65,75,90,97,123,44,6,False,False,False,172,213,medium,medium,low
692,Clauncher,Water,NaN,330,50,53,62,58,63,44,6,False,False,False,111,125,low,low,low
693,Clawitzer,Water,NaN,500,71,73,88,120,89,59,6,False,False,False,193,177,medium,medium,low
694,Helioptile,Electric,Normal,289,44,38,33,61,43,70,6,False,False,False,99,76,low,low,medium
695,Heliolisk,Electric,Normal,481,62,55,52,109,94,109,6,False,False,False,164,146,medium,low,medium
696,Tyrunt,Rock,Dragon,362,58,89,77,45,45,48,6,False,False,False,134,122,medium,low,low
697,Tyrantrum,Rock,Dragon,521,82,121,119,69,59,71,6,False,False,False,190,178,medium,medium,medium
698,Amaura,Rock,Ice,362,77,59,50,67,63,46,6,False,False,False,126,113,low,low,low
699,Aurorus,Rock,Ice,521,123,77,72,99,92,58,6,False,False,False,176,164,medium,low,low
700,Sylveon,Fairy,NaN,525,95,65,65,110,130,60,6,False,False,False,175,195,medium,medium,low
701,Hawlucha,Fighting,Flying,500,78,92,75,74,63,118,6,False,False,False,166,138,medium,low,medium
702,Dedenne,Electric,Fairy,431,67,58,57,81,67,101,6,False,False,False,139,124,medium,low,medium
703,Carbink,Rock,Fairy,500,50,50,150,50,150,50,6,False,False,False,100,300,low,medium,low
704,Goomy,Dragon,NaN,300,45,50,35,55,75,40,6,False,False,False,105,110,low,low,low
705,Sliggoo,Dragon,NaN,452,68,75,53,83,113,60,6,False,False,False,158,166,medium,low,low
706,Goodra,Dragon,NaN,600,90,100,70,110,150,80,6,False,False,False,210,220,medium,medium,medium
707,Klefki,Steel,Fairy,470,57,80,91,80,87,75,6,False,False,False,160,178,medium,medium,medium
708,Phantump,Ghost,Grass,309,43,70,48,50,60,38,6,False,False,False,120,108,low,low,low
709,Trevenant,Ghost,Grass,474,85,110,76,65,82,56,6,False,False,False,175,158,medium,low,low
710,PumpkabooAverage Size,Ghost,Grass,335,49,66,70,44,55,51,6,False,False,False,110,125,low,low,low
710,PumpkabooSmall Size,Ghost,Grass,335,44,66,70,44,55,56,6,False,False,False,110,125,low,low,low
710,PumpkabooLarge Size,Ghost,Grass,335,54,66,70,44,55,46,6,False,False,False,110,125,low,low,low
710,PumpkabooSuper Size,Ghost,Grass,335,59,66,70,44,55,41,6,False,False,False,110,125,low,low,low
711,GourgeistAverage Size,Ghost,Grass,494,65,90,122,58,75,84,6,False,False,False,148,197,medium,medium,medium
711,GourgeistSmall Size,Ghost,Grass,494,55,85,122,58,75,99,6,False,False,False,143,197,medium,medium,medium
711,GourgeistLarge Size,Ghost,Grass,494,75,95,122,58,75,69,6,False,False,False,153,197,medium,medium,medium
711,GourgeistSuper Size,Ghost,Grass,494,85,100,122,58,75,54,6,False,False,False,158,197,medium,medium,low
712,Bergmite,Ice,NaN,304,55,69,85,32,35,28,6,False,False,False,101,120,low,low,low
713,Avalugg,Ice,NaN,514,95,117,184,44,46,28,6,False,False,False,161,230,medium,medium,low
714,Noibat,Flying,Dragon,245,40,30,35,45,40,55,6,False,False,False,75,75,low,low,low
715,Noivern,Flying,Dragon,535,85,70,80,97,80,123,6,False,False,False,167,160,medium,low,high
716,Xerneas,Fairy,NaN,680,126,131,95,131,98,99,6,True,False,False,262,193,high,medium,medium
717,Yveltal,Dark,Flying,680,126,131,95,131,98,99,6,True,False,False,262,193,high,medium,medium
718,Zygarde50% Forme,Dragon,Ground,600,108,100,121,81,95,95,6,True,False,False,181,216,medium,medium,medium
719,Diancie,Rock,Fairy,600,50,100,150,100,150,50,6,True,False,False,200,300,medium,medium,low
719,Mega Diancie,Rock,Fairy,700,50,160,110,160,110,110,6,True,False,True,320,220,high,medium,medium
720,Hoopa Confined,Psychic,Ghost,600,80,110,60,150,130,70,6,True,False,False,260,190,high,medium,medium
720,Hoopa Unbound,Psychic,Dark,680,80,160,60,170,130,80,6,True,False,False,330,190,high,medium,medium
721,Volcanion,Fire,Water,600,80,110,120,130,90,70,6,True,False,False,240,210,medium,medium,medium
